####################
#                  #
#  ####     ####   #
#  #           #   #
#  #           #   #
#  ####     ####   #
#                  #
#  ####     ####   #
#  #           #   #
#  ####     ####   #
#                  #
#  ####           ##
#                  #
#  ####     ####   #
####################